A	A
B	B
C	C
Ç	C
D	D
E	E
F	F
G	G
Ğ	G
H	H
İ	I
I	I
J	J
K	K
L	L
M	M
N	N
O	O
Ö	O
P	P
Q	Q
R	R
S	S
Ş	S
T	T
U	U
Ü	U
V	V
W	W
X	X
Y	Y
Z	Z
a	a
b	b
c	c
ç	c
d	d
e	e
f	f
g	g
ğ	g
h	h
i	i
ı	i
j	j
k	k
l	l
m	m
n	n
o	o
ö	o
p	p
q	q
r	r
s	s
ş	s
t	t
u	u
ü	u
v	v
w	w
x	x
y	y
z	z